aa	aa
ae	ae
ah	ah
ao	ao
aw	aw
ax	ax
ay	ay
b	b
ch	ch
cl	cl
d	d
dh	dh
dx	dx
eh	eh
el	el
en	en
epi	epi
er	er
ey	ey
f	f
g	g
hh	hh
ih	ih
ix	ix
iy	iy
jh	jh
k	k
l	l
m	m
n	n
ng	ng
ow	ow
oy	oy
p	p
r	r
s	s
sh	sh
sil	sil
t	t
th	th
uh	uh
uw	uw
v	v
vcl	vcl
w	w
y	y
z	z
zh	zh
